accomplish a task	hoàn thành bài kiểm tra.
afraid	sợ.
amazed	ngạc nhiên.
appropriately	thích hợp, thích đáng.
assessment	đánh giá.
available	có sẵn.
beginner	người mới bắt đầu.
benefits	lợi ích.
caring	quan trọng.
center	trung tâm.
chicken pie	bánh gà.
collect	sưu tầm.
comnunication	giao tiếp.
concerned	quan tâm.
conflict	xung đột.
considerate	quan trọng.
court	sân tập.
deserts	sa mạc.
disappear	biến mất.
distract	sao lãng.
encourage	sống động.
energetic	tốn nhiều năng lượng.
expressive	biểu cảm.
factual	dữ liệu.
feeling free	không gò bó.
fluids	lỏng dễ cháy.
focus	trung tâm.
hadling	trình bày diễn xuất.
hands-on	trực tiếp.
incentives	động lực.
intimidating	đáng sợ.
make sure	quan tâm.
microsoftwave	lò vi sóng.
own	riêng mình.
personality	nhân cách.
physical exercise	bài tập thể chất.
progress	tiến bộ.
qualified	hướng dẫn.
reappear	trở lại.
revealed	bí mật.
scary	đáng sợ.
soft-hearted	trái tim mềm yếu.
spirited	biểu cảm.
temperaments	khí chất.
weekday	trong tuần.
